1111111111111111111111111111111111111111111
1P111111111111111111111E1111111111111111111
1100011000010001111011101111001110111110111
1101101011110110111011011110110111011101111
1101101011110110111010111110110111101011111
1100011000010001111001111101111011110111111
1101101011110110111010111100000011110111111
1101101011110111011011011011111101110111111
1100011000010111101011101011111101110111111
1C111111111111111111111C1111111111111111111
1111111111111111111111111111111111111111111