111111111111111111111111
1P1C1C0001C0001111111111
101011110000100111111111
101000000001001000000001
10001C1000011E0000000001
111111111111111111111111
