1111111111111111
1P1C1C0001C00011
1010111100011001
1010000000010011
10001C100E011101
1111111111111111
